###############################
#........................#..G.#
#.G......................#....#
#...............####.....####.#
#..............##.G#..........#
#.............##.E.#M.........#
#.............#G..............#
#.............########........#
#S...............G#G..........#
###############################
